1111111111111
1000000000001
1000000011001
10000E0001A01
1111111111111
