1111111111111
100C000C00001
1000000011011
100000E001P01
1111111111111
