111111111111111111
10C100010000000C01
100100010100000001
1E0000C001P0000001
111111111111111111
