1111111111111111111111111111111111111111111111111111
1000000000000000000011110000000000000000000000000001
1000000000000000000001100000000000000000000000000001
10000000000000000000001000000C0000000000000000000001
1000000000000000000000000000000000000000000000000001
1000000000000000000000000000000000000000000000000001
1000000000000C00110000000000000000000000000000000001
1000000000000000010000000000000000000000000000000001
1000000000000000011100000000000000000000000000000001
1000000000000000000000000000000000000000000000000001
1000000000000000000000000000000000000000000000000001
1000000000000000000000000000000000000000000000000001
1000000000000000000000000000000000000000000000000001
1000000000000000000000000000000000000000000000000001
1000000000000000000000000000000000000000000000000001
100000000000000000P000000000000000000000000000000001
1000000000000000000000000000000000000000000000000001
1000000000000000000E00000000000000000000000000000001
1111111111111111111111111111111111111111111111111111
