1111111111111111111111111111111111
1P001C0000000000000000000100000001
10001111111011111011111001C1000001
10000000011010001010C0100101111111
1C000000000010000000001000000000E1
1111111111111111111111111111111111
