1111111111111111111111111111111111
10000000E0000000000000000000000001
1010010100100000101001000000010101
101001001010101000100100P000010101
100000000000C000000000000000000001
1111111111111111111111111111111111
